5,3
11111111111111111111111111111111111111111111111111111111111111111111111111111111111
10000000000000000000000000000000000000000000000001111111111110000000000000000000001
10000000000000000000000000000000000000000000000000111111111100000000000000000000001
10000000000000000000000000000000000000000000000000000000000000000000000000000000001
10000000000000000000000000000000000000000000000000000000000000000000000000000000001
10000000000000000000000000000000000000000000000000000000000000000000000000000000001
10000000000000000000000000000000000000000000000000000000000000000000000000000000001
10000000000000000000000000000000000000000000000000000000000000000000000000000000001
10000000000000000000000000000000000000111111100000000000000000000000000000000000001
11111111000011111111110001111111111111111100000000000000000000111111110000000000001
11111111000000000000000000000000000000000000000000000000000000011111110000000000001
11111111000000000000000000000000000000000000000000000000000000000111110000000000001
11111111222222222222222222222222222222222222222222222222222222222000000000000000001
11111111111111111111111111111111111111111111111111111111111111111111110000000000001
11111111111111111111111111111111111111111111111111111111111111111111110000000000001
11111111111111111111111111111111111111111111111111111111111111111111110000000000001
11111111111111111111111111111111111111111111111111111111111111111111110000000000001
10000030000100011111111100000000000000111111111000000000000001111111100000000000001
10000030000100000000000000000000000000000000000000000000000000000000000000000000001
10000030000100000000000000111111100000000000000000000000000000000000000000000000001
10000030000100000000000000000000000000000000000000000000000000000000000000000000001
10000030000000000000000000000000000000000000000000000000000000000000000000000000001
10000030000000000000000000111111100000000000000000000000000000000000000000000000001
10000030000000000000000000000000000000000000000000011111110000000000000001111111001
10000030000100000000000000000000000000000000000000000000000000000000000001111111001
11111111111110000000000000111111100000000000000000000000000000000000000000000000001
11111111111101000000000000000000000000000000000000000000000000000000000000000000001
11111111111100100000000000000000000000000000000000000000000000000000000000000000001
11111111111111111111111111111111111111111111111111111111111111111111111111111111111
11111111111111111111111111111111111111111111111111111111111111111111111111111111111
