3, 4
1111111111111111111111111111111111111111111111111111111111111111111111111111111111
1000001111111111111111111111111111111111111111111111111111111111111111003000000001
1000001111111111111111111111111111111111111111111111111111111111111111003000000001
1000001111111111111111111111111111111111111111111111111111111111111111003000000001
1000001111111111111111111111111111111111111111111111111111111111111111111100000001
1000001111111111111111111111111111111111111111111111111111111111111111000000000001
1000001111111111111111111111111111111111111111111111111111111111111111000000001111
1000001111111111111111111111111111111111111111111111111111111111111111000000000001
1000001111111111111111111111111111111111111111111111111111111111111111000000000001
1000001111111111111111111111111111111111111111111111111111111111111111111000000001
1000001111111111111111111111111111111111111111111111111111111111111111000000000001
1000001111111111111111111111111111111111111111111111111111111111111111000000000001
1000001111111111111111111111111111111111111111111111111111111111111111000000001111
1000001111111111111111111111111111111111111111111111111111111111111111000000000001
1000001111111111111111111111111111111111111111111111111111111111111111000000000001
1000001111111111111111111111111111111111111111111111111111111111111111111000000001
1000001111111111111111111111111111111111111111111111111111111111111111000000000001
1000001111111111111111111111111111111111111111111111111111111111111111000000000001
1000002222222222222222222222222222222222222222222222222222222000000000000000001111
1000000000000000000000000000000000000000000000000000000000000000000000000000000001
1000000000000000000000000000000000000000000000000000000000000000000000000000000001
1000000000000000000000000000000000000000000000000000000000000000000000000000000001
1000000000111111100000001111100000000011111110000000111100000111111111111111111111
1000000000011111000000001111100000000001111100000000011000000011111111111111111111
1000000000000000000000000000000000000000000000000000000000000011111111111111111111
1000000000000000000000000000000000000000000000000000000000000001111111111111111111
1222222222222222222222222222222222222222222222222222222222222222222222222222222222
