42,4
111111111111111111111111111111111111111111111111111111111111111111111111111111111111
100000000000000000000000000000000000000000000000000000000000000000000000000000000001
100000000000000000000000000000000000000000000000000000000000000000000000000000000001
100000000000000000000000000000000000000000000000000000000000000000000000000000000001
100000000000000000000000000000000000000000000000000000000000000000000000000000000001
100000000000000000000000000000000000011111111100000000000000000000000000000000000001
100000000111111111111111111111111111111111111111111111111111111111111111111000000001
111100000111111111111111111111111111111111111111111111111111111111111111111000011111
100000000111111111111111111111111111111111111111111111111111111111111111111000000001
100000000111111111111111111111111111111111111111111111111111111111111111111000000001
100001111111111111111111111111111111111111111111111111111111111111111111111111100001
100000000111110000000000000000000000000000000000000000000000000000000011111000000001
100000000111110000000000000000000000000000000000000000000000000000000011111000000001
100000000111110000000000000000000000000000000000000000000000000000000011111000000001
111110000111110000000000000000000000000100010000000000000000000000000011111000011111
100000000000000000000000000000000000001100011000000000000000000000000000000000000001
100000000000000000000000000000000000011100011100000000000000000000000000000000000001
100000000000000000000000000000000000111100011110000000000000000000000000000000000001
100000000111111111111111111111111111111100011111111111111111111111111111110000000001
122222221111111111111111111111111111111100011111111111111111111111111111111000000001
111111111111111111111111111111111111111100011111111111111111111111111111111222222221
111111111111111111111111111111111111111100011111111111111111111111111111111111111111
111111111111111111111111111111111111111100011111111111111111111111111111111111111111
111111111111111111111111111111111111111100011111111111111111111111111111111111111111
111111111111111111111111111111111111111100011111111111111111111111111111111111111111
111111111111111111111111111111111111111100011111111111111111111111111111111111111111
111111111111111111111111111111111111111100011111111111111111111111111111111111111111
111111111111111111111111111111111111111100011111111111111111111111111111111111111111
111111111111111111111111111111111111111100011111111111111111111111111111111111111111
111111111111111111111111111111111111111100011111111111111111111111111111111111111111
111111111111111111111111111111111111111100011111111111111111111111111111111111111111
111111111111111110000300000000000000000000011111111111111111111111111111111111111111
111111111111111110000300000000000000000000011111111111111111111111111111111111111111
111111111111111110000300000000000000000000011111111111111111111111111111111111111111
111111111111111110000300000000000000000000011111111111111111111111111111111111111111
111111111111111111111111111111111110000000011111111111111111111111111111111111111111
111111111111111111111111111111111110000000011111111111111111111111111111111111111111
111111111111111111111111111111111110000000011111111111111111111111111111111111111111
111111111111111111111111111111111112222222211111111111111111111111111111111111111111
111111111111111111111111111111111111111111111111111111111111111111111111111111111111
111111111111111111111111111111111111111111111111111111111111111111111111111111111111
