4,4
1111111111111111111111111111111111111111111111111111111111111111111111111111111111111
1000000000000000000000000000000000000000000000001222222210000000000000000000000000001
1000000000000000000000000000000000000000000000001000000010000000000000000000000000001
1000000000000000000000000000000001111111110000001000000010000000000000000000000000001
1000000000000000000000000000000001000000010000000000000010000000111111111111100000001
1111111110000000111111111111111111100000010000000000000010000000100000000000100000001
1000000000000000000000001000000000000000111111111111111100000000100000000000100000001
1000000000000000000000001000000000000000000000000000000000000000100000100000100000001
1000000000000000000000001000000000000000000000000000000000000000100000100000100000001
1000000000000000000000001000000000000000000000000000000000000000122222100000100000001
1000000022222222000000001000000011111111100000001111111111111111111111100000100000001
1000000011111111000000001000000011111111100000000000000100000000000000100000100000001
1000000011111111000000001000000011111111100000000000000100000000000000100000100000001
1000000011111111122222221000000011111111100000001000000100000010000000100000100000001
1000000011111111111111111000000011111111100000001000000100000010000000100000100000001
1000000000000000000000000000000011111111100000001000000000000010000000100000100000001
1000000000000000000000000000000011111111100000001000000000000012222222100000100000001
1000000000000000000000000000000011111111111111111111111111111111111111100000100000001
1111111110000000111111111111111111111111111111111111111111111111111111100000100000001
1111111110000000111111111111111111111111111111111111111111111111100000000000000000001
1111111110000000111111111111111111111111111111111111111111111111100000000000000000001
1111111110000000111111111111111111111111111111111111111111111111100000000000000000001
1111111112222222111111111111111111111111111111111111111111111111100000011111100000001
1111111111111111111111111111111111111111111111111111111111111111100000012222100000001
1000000000000000000000000000000000000000000000000000000000000000000000010000100000001
1000000000000000000000000000000000000000000000000000000000000000000000010000100000001
1000000000000000000000000000000000000000000000000000000000000000000000010000100000001
1000000000000000000000000000000000000000000000000000000011100000000000000000100000001
1000000000000000000000000000000000000000000111100000000000000000000000000000100000001
1000000000000000000111000000000111100000000000000000000000000000011110000000100000001
1000000000000000000000000000000000000000000000000000000000000000000000020000100000001
1000000000000000000000000000000000000000000000000000000000000000000000012222122222221
1000000000000000000000000000000000000000000000000000000000000000000000011111111111111
1000000000222222222222222222222222222222222222222222222222222222222222210000030000001
1111000000111111111111111111111111111111111111111111111111111111111111110000030000001
1000000000000000000000000000000000000000000000000000000000000000000000000000030000001
1000000000000000000000000000000000000000000000000000000000000000000000000000030000001
1222211111222221111122222111111222221111122221111222221111222222111222211111111111111
