7,2
1111111111111111111111111111111111111111111111111111111111111111111
1000000000000000000000000000000000000000000000000000000000000000001
1000000000000000000000000000000000000000000000000000000000000000001
1000000000000000000000000000000000000000000000000000000000000000001
1001111111000111111100001111111100011111111000011111111100000000001
1000111110000011111000000111111000001111100000000011110000000000001
1000000000000000000000000000000000000000000000000000000000000000001
1222222222222222222222222222222222222222222222222222222000000000001
1111111111111111111111111111111111111111111111111111111000000000001
1000000000000000000000000000000000000000000000000000000000000000001
1000000000000000000000000000000000000000000000000000000000000000001
1000000000000000000000000000000000000000000000000000000000000000001
1000000000000000000000000000000000000000000000000000000000000000001
1000000000000000000000000000000000000000000000000000000000000000001
1000000000000000000000000000000000000000000000000000000000000000001
1000011111000000111111100000000000111111110000000000000011111111001
1000000000000000000000000000000000000000000000000000000000000000001
1000000000000000000000000000000000000000000000000000000000000000001
1000000222222222222222222222222222222222222222222222222222222222221
1000000111111111111111111111111111111111111111111111111111111111111
1000000000000000000000000000000000000000000000000000000000000000001
1000000000000000000000000000000000000000000000000000000000000330001
1000000000000000000000000000000000000000000000000000000000000330001
1000000000000000000000000000000000000000000000000000000000000330001
1000000000000000000000000000000000000000000000000000000000000330001
1000000000000000000000000000000000000000000000000000000000011111111
1000000000000000000000000000000000000000000000000000000000011111111
1222222222222222222222222222222222222222222222222222222222211111111
1111111111111111111111111111111111111111111111111111111111111111111